16 6 3 4 19 19 2 19 19 19 23 18 19 24 2 16
16 8 3 9 13 2 1 1 2 1 23 19 18 24 1 16
16 8 3 3 9 13 01 01 16 20 31 28 26 27 1 2
16 14 5 6 03 07 02 02 01 23 19 24 1 2 1 16
16 01 02 08 03 07 01 2 02 25 26 27 1 1 1 2
16 01 01 08 03 07 01 2 1 1 1 2 2 1 1 1 
16 02 01 8 03 07 01 01 1 2 2 1 1 1 1 1
16 33 33 33 03 7 01 01 2 2 1 1 1 1 2 1
16 32 32 32 03 7 01 01 1 1 2 1 1 2 2 1
16 32 34 32 03 7 1 1 1 1 2 2 1 1 1 2
16 32 34 32 3 7 1 1 1 1 2 2 1 2 1 2
16 5 5 5 5 15 1 1 1 1 16 1 2 2 1 1